============
=       1  =
=          =
=    S     =
============
= 1  2 =2 E=
============