============
=       1  =
=E         =
=    S     =
=          =
= 1        =
============