=======/=====//=============
=     =/=  1=//= E         =
=S    ===   =//=           =
=       =   =//=          2=
=============//=============
=    ========//=1        B2=
=============//=============