==============
=S T   =1=   =
=  B=  =B=T= =
= BB=  = === =
===E=        =
=1 B=       T=
==============