=======/=====//=============
=     === T1=//= E         =
=S        TT=//=           =
=           //=          2 =
=============//=============
=    ========//=1        B2=
=============//=============